0 16 16 0 0 1 1 0 0 1 1 0 0 1 1 0
1 15 15 1 1 0 0 1 1 0 0 1 1 0 0 1
0 14 14 0 0 1 1 0 0 1 1 0 0 1 1 0
1 0 0 1 1 0 0 1 1 0 0 1 1 0 0 1
0 1 1 0 0 1 1 0 0 1 1 0 0 1 1 0
1 0 0 1 1 0 0 1 1 0 0 1 1 0 0 1
0 1 1 0 0 1 1 0 0 1 1 0 0 1 1 0
1 0 0 1 1 0 0 1 1 0 0 1 1 0 0 1
0 1 1 0 0 1 1 0 0 1 1 0 0 1 1 0
1 0 0 1 1 0 0 1 1 0 0 1 1 0 0 1
0 1 1 0 0 1 1 0 0 1 1 0 0 1 1 0
1 0 0 1 1 0 0 1 1 0 0 1 1 0 0 1